{"mapa_pc": [[2, 0, 1, 0, 1, 0, 1, 0, 0, 0],
             [2, 0, 1, 0, 0, 0, 0, 0, 0, 0],
             [2, 0, 0, 0, 1, 0, 0, 0, 0, 0],
             [2, 0, 1, 0, 0, 0, 0, 0, 0, 0],
             [2, 0, 1, 0, 1, 0, 0, 0, 0, 0],
             [0, 0, 1, 0, 1, 0, 1, 0, 0, 0],
             [1, 0, 0, 0, 0, 0, 0, 1, 0, 0],
             [1, 0, 1, 0, 1, 0, 1, 0, 0, 0],
             [1, 0, 1, 0, 1, 0, 0, 0, 1, 0],
             [1, 0, 1, 0, 1, 0, 0, 1, 0, 1]],

 "mapa_ia": [[1, 0, 1, 0, 1, 0, 1, 0, 0, 0],
             [1, 0, 1, 0, 0, 0, 0, 0, 0, 0],
             [1, 0, 0, 0, 1, 0, 0, 0, 0, 0],
             [1, 0, 1, 0, 0, 0, 0, 0, 0, 0],
             [1, 0, 1, 0, 1, 0, 0, 0, 0, 0],
             [0, 0, 1, 0, 1, 0, 1, 0, 0, 0],
             [1, 0, 0, 0, 0, 0, 0, 1, 0, 0],
             [1, 0, 1, 0, 1, 0, 1, 0, 0, 0],
             [1, 0, 1, 0, 1, 0, 0, 0, 1, 0],
             [1, 0, 1, 0, 1, 0, 0, 1, 0, 1]]
}