{"mapa_pc": [[5, 0, 2, 0, 1, 0, 1, 0, 0, 0], 
             [5, 0, 2, 0, 0, 0, 0, 0, 0, 0],
             [5, 0, 0, 0, 1, 0, 0, 0, 0, 0],
             [5, 0, 3, 0, 0, 0, 0, 0, 0, 0],
             [5, 0, 3, 0, 2, 0, 0, 0, 0, 0],
             [0, 0, 3, 0, 2, 0, 6, 0, 0, 0],
             [4, 0, 0, 0, 0, 0, 0, 6, 0, 0],
             [4, 0, 3, 0, 3, 0, 6, 0, 0, 0],
             [4, 0, 3, 0, 3, 0, 0, 0, 6, 0],
             [4, 0, 3, 0, 3, 0, 0, 6, 0, 6]],

 "mapa_ia": [[5, 0, 2, 0, 1, 0, 1, 0, 0, 0], 
             [5, 0, 2, 0, 0, 0, 0, 0, 0, 0],
             [5, 0, 0, 0, 1, 0, 0, 0, 0, 0],
             [5, 0, 3, 0, 0, 0, 0, 0, 0, 0],
             [5, 0, 3, 0, 2, 0, 0, 0, 0, 0],
             [0, 0, 3, 0, 2, 0, 6, 0, 0, 0],
             [4, 0, 0, 0, 0, 0, 0, 6, 0, 0],
             [4, 0, 3, 0, 3, 0, 6, 0, 0, 0],
             [4, 0, 3, 0, 3, 0, 0, 0, 6, 0],
             [4, 0, 3, 0, 3, 0, 0, 6, 0, 6]],

"mapa_aux0":[[1, 0, 0, 0, 6, 0, 6, 0, 2, 2], 
             [0, 0, 0, 0, 0, 6, 0, 0, 0, 0],
             [0, 3, 3, 3, 0, 0, 0, 0, 0, 0],
             [0, 0, 0, 0, 0, 0, 0, 0, 0, 4],
             [0, 0, 0, 5, 5, 5, 5, 5, 0, 4],
             [2, 0, 0, 0, 0, 0, 0, 0, 0, 4],
             [2, 0, 3, 0, 3, 3, 3, 0, 0, 4],
             [0, 0, 3, 0, 0, 0, 0, 0, 0, 0],
             [0, 0, 3, 0, 0, 6, 0, 0, 0, 0],
             [1, 0, 0, 0, 6, 0, 6, 0, 0, 1]],

"mapa_aux1":[[3, 0, 4, 0, 2, 0, 0, 0, 0, 0], 
             [3, 0, 4, 0, 2, 0, 0, 3, 3, 3],
             [3, 0, 4, 0, 0, 0, 0, 0, 0, 0],
             [0, 0, 4, 0, 0, 0, 0, 0, 0, 0],
             [3, 0, 0, 0, 0, 0, 0, 0, 0, 1],
             [3, 0, 6, 0, 0, 0, 0, 6, 0, 0],
             [3, 0, 0, 6, 0, 0, 6, 0, 0, 0],
             [0, 0, 6, 0, 0, 0, 0, 6, 0, 1],
             [0, 0, 0, 0, 0, 0, 0, 0, 0, 0],
             [2, 2, 0, 1, 0, 5, 5, 5, 5, 5]],


"mapa_aux2":[[0, 0, 0, 3, 3, 3, 0, 0, 0, 1], 
             [0, 4, 0, 0, 0, 0, 0, 1, 0, 0],
             [0, 4, 0, 0, 0, 0, 0, 0, 0, 0],
             [0, 4, 0, 6, 0, 6, 0, 2, 0, 1],
             [0, 4, 0, 0, 6, 0, 0, 2, 0, 0],
             [0, 0, 0, 0, 0, 0, 0, 0, 0, 3],
             [0, 0, 0, 3, 3, 3, 0, 0, 0, 3],
             [6, 0, 0, 0, 0, 0, 0, 0, 0, 3],
             [0, 6, 0, 2, 0, 0, 0, 0, 0, 0],
             [6, 0, 0, 2, 0, 5, 5, 5, 5, 5]],

"mapa_aux3":[[6, 0, 6, 0, 1, 0, 2, 2, 0, 1], 
             [0, 6, 0, 0, 0, 0, 0, 0, 0, 0],
             [0, 0, 0, 0, 3, 0, 2, 0, 0, 0],
             [0, 0, 0, 0, 3, 0, 2, 0, 3, 0],
             [4, 0, 0, 0, 3, 0, 0, 0, 3, 0],
             [4, 0, 0, 0, 0, 0, 0, 0, 3, 0],
             [4, 0, 0, 0, 0, 0, 0, 0, 0, 0],
             [4, 0, 1, 0, 3, 3, 3, 0, 0, 6],
             [0, 0, 0, 0, 0, 0, 0, 0, 6, 0],
             [5, 5, 5, 5, 5, 0, 0, 0, 0, 6]],

"mapa_aux4":[[5, 5, 5, 5, 5, 0, 4, 0, 0, 6], 
             [0, 0, 0, 0, 0, 0, 4, 0, 6, 0],
             [3, 0, 1, 0, 0, 0, 4, 0, 0, 6],
             [3, 0, 0, 0, 0, 0, 4, 0, 0, 0],
             [3, 0, 1, 0, 0, 0, 0, 0, 0, 0],
             [0, 0, 0, 0, 1, 0, 0, 0, 0, 2],
             [3, 3, 3, 0, 0, 0, 0, 0, 0, 2],
             [0, 0, 0, 0, 0, 0, 0, 0, 0, 0],
             [6, 0, 6, 0, 3, 3, 3, 0, 0, 2],
             [0, 6, 0, 0, 0, 0, 0, 0, 0, 2]],

"mapa_aux5":[[6, 0, 0, 5, 0, 2, 2, 0, 0, 6], 
             [0, 6, 0, 5, 0, 0, 0, 0, 6, 0],
             [6, 0, 0, 5, 0, 3, 0, 0, 0, 6],
             [0, 0, 0, 5, 0, 3, 0, 0, 0, 0],
             [2, 0, 0, 5, 0, 3, 0, 0, 0, 3],
             [2, 0, 0, 0, 0, 0, 0, 0, 0, 3],
             [0, 0, 0, 0, 0, 0, 0, 0, 0, 3],
             [3, 0, 4, 4, 4, 4, 0, 0, 0, 0],
             [3, 0, 0, 0, 0, 0, 0, 0, 0, 0],
             [3, 0, 1, 0, 1, 0, 0, 0, 0, 1]],

"mapa_aux6":[[0, 3, 3, 3, 0, 2, 2, 0, 0, 4], 
             [0, 0, 0, 0, 0, 0, 0, 0, 0, 4],
             [0, 3, 3, 3, 0, 2, 2, 0, 0, 4],
             [0, 0, 0, 0, 0, 0, 0, 0, 0, 4],
             [0, 3, 0, 0, 6, 0, 0, 0, 0, 0],
             [0, 3, 0, 0, 0, 6, 0, 1, 0, 1],
             [0, 3, 0, 0, 6, 0, 0, 0, 0, 0],
             [0, 0, 0, 0, 0, 0, 0, 0, 0, 1],
             [0, 0, 6, 0, 0, 0, 0, 0, 0, 0],
             [0, 6, 0, 6, 0, 5, 5, 5, 5, 5]]

}