{"mapa_0":  [[5, 0, 2, 0, 1, 0, 1, 0, 0, 0], 
             [5, 0, 2, 0, 0, 0, 0, 0, 0, 0],
             [5, 0, 0, 0, 1, 0, 0, 0, 0, 0],
             [5, 0, 3, 0, 0, 0, 0, 0, 0, 0],
             [5, 0, 3, 0, 2, 0, 0, 0, 0, 0],
             [0, 0, 3, 0, 2, 0, 6, 0, 0, 0],
             [4, 0, 0, 0, 0, 0, 0, 6, 0, 0],
             [4, 0, 3, 0, 3, 0, 6, 0, 0, 0],
             [4, 0, 3, 0, 3, 0, 0, 0, 6, 0],
             [4, 0, 3, 0, 3, 0, 0, 6, 0, 6]],

"mapa_1":   [[1, 0, 0, 0, 6, 0, 6, 0, 2, 2], 
             [0, 0, 0, 0, 0, 6, 0, 0, 0, 0],
             [0, 3, 3, 3, 0, 0, 0, 0, 0, 0],
             [0, 0, 0, 0, 0, 0, 0, 0, 0, 4],
             [0, 0, 0, 5, 5, 5, 5, 5, 0, 4],
             [2, 0, 0, 0, 0, 0, 0, 0, 0, 4],
             [2, 0, 3, 0, 3, 3, 3, 0, 0, 4],
             [0, 0, 3, 0, 0, 0, 0, 0, 0, 0],
             [0, 0, 3, 0, 0, 6, 0, 0, 0, 0],
             [1, 0, 0, 0, 6, 0, 6, 0, 0, 1]],

"mapa_2":   [[3, 0, 4, 0, 2, 0, 0, 0, 0, 0], 
             [3, 0, 4, 0, 2, 0, 0, 3, 3, 3],
             [3, 0, 4, 0, 0, 0, 0, 0, 0, 0],
             [0, 0, 4, 0, 0, 0, 0, 0, 0, 0],
             [3, 0, 0, 0, 0, 0, 0, 0, 0, 1],
             [3, 0, 6, 0, 0, 0, 0, 6, 0, 0],
             [3, 0, 0, 6, 0, 0, 6, 0, 0, 0],
             [0, 0, 6, 0, 0, 0, 0, 6, 0, 1],
             [0, 0, 0, 0, 0, 0, 0, 0, 0, 0],
             [2, 2, 0, 1, 0, 5, 5, 5, 5, 5]],


"mapa_3":   [[0, 0, 0, 3, 3, 3, 0, 0, 0, 1], 
             [0, 4, 0, 0, 0, 0, 0, 1, 0, 0],
             [0, 4, 0, 0, 0, 0, 0, 0, 0, 0],
             [0, 4, 0, 6, 0, 6, 0, 2, 0, 1],
             [0, 4, 0, 0, 6, 0, 0, 2, 0, 0],
             [0, 0, 0, 0, 0, 0, 0, 0, 0, 3],
             [0, 0, 0, 3, 3, 3, 0, 0, 0, 3],
             [6, 0, 0, 0, 0, 0, 0, 0, 0, 3],
             [0, 6, 0, 2, 0, 0, 0, 0, 0, 0],
             [6, 0, 0, 2, 0, 5, 5, 5, 5, 5]],

"mapa_4":   [[6, 0, 6, 0, 1, 0, 2, 2, 0, 1], 
             [0, 6, 0, 0, 0, 0, 0, 0, 0, 0],
             [0, 0, 0, 0, 3, 0, 2, 0, 0, 0],
             [0, 0, 0, 0, 3, 0, 2, 0, 3, 0],
             [4, 0, 0, 0, 3, 0, 0, 0, 3, 0],
             [4, 0, 0, 0, 0, 0, 0, 0, 3, 0],
             [4, 0, 0, 0, 0, 0, 0, 0, 0, 0],
             [4, 0, 1, 0, 3, 3, 3, 0, 0, 6],
             [0, 0, 0, 0, 0, 0, 0, 0, 6, 0],
             [5, 5, 5, 5, 5, 0, 0, 0, 0, 6]],

"mapa_5":   [[5, 5, 5, 5, 5, 0, 4, 0, 0, 6], 
             [0, 0, 0, 0, 0, 0, 4, 0, 6, 0],
             [3, 0, 1, 0, 0, 0, 4, 0, 0, 6],
             [3, 0, 0, 0, 0, 0, 4, 0, 0, 0],
             [3, 0, 1, 0, 0, 0, 0, 0, 0, 0],
             [0, 0, 0, 0, 1, 0, 0, 0, 0, 2],
             [3, 3, 3, 0, 0, 0, 0, 0, 0, 2],
             [0, 0, 0, 0, 0, 0, 0, 0, 0, 0],
             [6, 0, 6, 0, 3, 3, 3, 0, 0, 2],
             [0, 6, 0, 0, 0, 0, 0, 0, 0, 2]],

"mapa_6":   [[6, 0, 0, 5, 0, 2, 2, 0, 0, 6], 
             [0, 6, 0, 5, 0, 0, 0, 0, 6, 0],
             [6, 0, 0, 5, 0, 3, 0, 0, 0, 6],
             [0, 0, 0, 5, 0, 3, 0, 0, 0, 0],
             [2, 0, 0, 5, 0, 3, 0, 0, 0, 3],
             [2, 0, 0, 0, 0, 0, 0, 0, 0, 3],
             [0, 0, 0, 0, 0, 0, 0, 0, 0, 3],
             [3, 0, 4, 4, 4, 4, 0, 0, 0, 0],
             [3, 0, 0, 0, 0, 0, 0, 0, 0, 0],
             [3, 0, 1, 0, 1, 0, 0, 0, 0, 1]],

"mapa_7":   [[0, 3, 3, 3, 0, 2, 2, 0, 0, 4], 
             [0, 0, 0, 0, 0, 0, 0, 0, 0, 4],
             [0, 3, 3, 3, 0, 2, 2, 0, 0, 4],
             [0, 0, 0, 0, 0, 0, 0, 0, 0, 4],
             [0, 3, 0, 0, 6, 0, 0, 0, 0, 0],
             [0, 3, 0, 0, 0, 6, 0, 1, 0, 1],
             [0, 3, 0, 0, 6, 0, 0, 0, 0, 0],
             [0, 0, 0, 0, 0, 0, 0, 0, 0, 1],
             [0, 0, 6, 0, 0, 0, 0, 0, 0, 0],
             [0, 6, 0, 6, 0, 5, 5, 5, 5, 5]],

"mapa_8":   [[0, 0, 2, 1, 0, 1, 0, 2, 0, 5], 
             [0, 0, 2, 0, 0, 0, 0, 2, 0, 5],
             [0, 0, 0, 0, 0, 1, 0, 0, 0, 5],
             [0, 0, 3, 0, 0, 0, 0, 3, 0, 5],
             [0, 0, 3, 0, 0, 2, 0, 3, 0, 5],
             [0, 0, 0, 6, 0, 2, 0, 3, 0, 0],
             [0, 0, 6, 0, 0, 0, 0, 0, 0, 4],
             [0, 0, 0, 6, 0, 3, 0, 3, 0, 4],
             [0, 6, 0, 0, 0, 3, 0, 3, 0, 4],
             [6, 0, 6, 0, 0, 3, 0, 3, 0, 4]],

"mapa_9":   [[2, 2, 0, 6, 0, 6, 0, 0, 0, 1], 
             [0, 0, 0, 0, 6, 0, 0, 0, 0, 0],
             [0, 0, 0, 0, 0, 0, 3, 3, 3, 0],
             [4, 0, 0, 0, 0, 0, 0, 0, 0, 0],
             [4, 0, 5, 5, 5, 5, 5, 0, 0, 0],
             [4, 0, 0, 0, 0, 0, 0, 0, 0, 2],
             [4, 0, 0, 3, 3, 3, 0, 3, 0, 2],
             [0, 0, 0, 0, 0, 0, 0, 3, 0, 0],
             [0, 0, 0, 0, 6, 0, 0, 3, 0, 0],
             [1, 0, 0, 6, 0, 6, 0, 0, 0, 1]],

"mapa_10":  [[0, 0, 0, 0, 0, 0, 0, 4, 0, 3], 
             [3, 3, 3, 0, 2, 2, 0, 4, 0, 3],
             [0, 0, 0, 0, 0, 0, 0, 4, 0, 3],
             [0, 0, 0, 0, 2, 2, 0, 4, 0, 0],
             [1, 0, 0, 0, 0, 0, 0, 0, 0, 3],
             [0, 0, 6, 0, 0, 0, 0, 6, 0, 3],
             [0, 0, 0, 6, 0, 0, 6, 0, 0, 3],
             [1, 0, 6, 0, 0, 0, 0, 6, 0, 0],
             [0, 0, 0, 0, 0, 0, 0, 0, 0, 0],
             [5, 5, 5, 5, 5, 0, 1, 0, 2, 2]],

"mapa_11":  [[0, 0, 0, 0, 0, 0, 0, 6, 0, 6], 
             [0, 4, 4, 4, 4, 0, 0, 0, 6, 0],
             [0, 0, 0, 0, 0, 0, 0, 0, 0, 0],
             [3, 0, 0, 6, 0, 0, 3, 0, 2, 2], 
             [3, 0, 0, 0, 6, 0, 3, 0, 0, 0], 
             [3, 0, 0, 6, 0, 0, 3, 0, 0, 5], 
             [0, 0, 0, 0, 0, 0, 0, 0, 0, 5], 
             [0, 1, 0, 2, 2, 0, 0, 0, 0, 5], 
             [0, 0, 0, 0, 0, 0, 0, 0, 0, 5], 
             [1, 0, 0, 1, 0, 3, 3, 3, 0, 5]],

"mapa_12":[  [6, 0, 0, 0, 4, 4, 4, 4, 0, 5],
             [0, 6, 0, 0, 0, 0, 0, 0, 0, 5],
             [6, 0, 0, 0, 0, 0, 0, 1, 0, 5],
             [0, 0, 0, 0, 0, 0, 0, 0, 0, 5],
             [1, 0, 3, 3, 3, 0, 0, 3, 0, 5],
             [0, 0, 0, 0, 0, 0, 0, 3, 0, 0],
             [2, 0, 2, 2, 0, 0, 0, 3, 0, 0],
             [2, 0, 0, 0, 0, 0, 0, 0, 0, 0],
             [0, 0, 0, 3, 3, 3, 0, 0, 6, 0],
             [1, 0, 0, 0, 0, 0, 0, 6, 0, 6]],

"mapa_13":  [[5, 0, 3, 3, 3, 0, 3, 0, 6, 0],
             [5, 0, 0, 0, 0, 0, 3, 0, 0, 6],
             [5, 0, 1, 0, 1, 0, 3, 0, 6, 0],
             [5, 0, 0, 0, 0, 0, 0, 0, 0, 0],
             [5, 0, 0, 0, 0, 1, 0, 0, 3, 0],
             [0, 0, 0, 0, 0, 0, 0, 0, 3, 0],
             [4, 4, 4, 4, 0, 0, 0, 0, 3, 0],
             [0, 0, 6, 0, 0, 0, 0, 0, 0, 0],
             [0, 0, 0, 0, 0, 0, 0, 0, 0, 0],
             [6, 0, 6, 0, 0, 2, 2, 0, 2, 2]],

"mapa_14":  [[6, 0, 6, 0, 2, 2, 0, 3, 3, 3],
             [0, 6, 0, 0, 0, 0, 0, 0, 0, 0],
             [0, 0, 0, 0, 0, 0, 0, 4, 0, 1],
             [5, 5, 5, 5, 5, 0, 0, 4, 0, 0],
             [0, 0, 0, 0, 0, 0, 0, 4, 0, 1],
             [2, 0, 3, 3, 3, 0, 0, 4, 0, 0],
             [2, 0, 0, 0, 0, 0, 0, 0, 0, 0],
             [0, 0, 0, 0, 0, 0, 0, 0, 0, 0],
             [0, 6, 0, 0, 0, 0, 0, 0, 0, 0],
             [6, 0, 6, 0, 3, 3, 3, 0, 0, 1]],

"mapa_15":  [[0, 0, 0, 0, 0, 0, 0, 0, 0, 0],
             [3, 0, 3, 0, 3, 3, 3, 0, 0, 6],
             [3, 0, 3, 0, 0, 0, 0, 0, 6, 0],
             [3, 0, 3, 0, 0, 0, 0, 0, 0, 6],
             [0, 0, 0, 0, 6, 0, 6, 0, 0, 0],
             [2, 0, 2, 0, 0, 6, 0, 0, 0, 5],
             [2, 0, 2, 0, 0, 0, 0, 0, 0, 5],
             [0, 0, 0, 0, 0, 1, 0, 0, 0, 5],
             [0, 0, 0, 0, 0, 0, 0, 0, 0, 5],
             [4, 4, 4, 4, 0, 1, 0, 1, 0, 5]],

"mapa_16":  [[5, 5, 5, 5, 5, 0, 4, 4, 4, 4],
             [0, 0, 0, 0, 0, 0, 0, 0, 0, 0],
             [2, 2, 0, 3, 3, 3, 0, 3, 3, 3],
             [0, 0, 0, 0, 0, 0, 0, 0, 0, 0],
             [1, 0, 1, 0, 2, 2, 0, 3, 3, 3],
             [0, 0, 0, 0, 0, 0, 0, 0, 0, 0],
             [1, 0, 0, 0, 0, 6, 0, 6, 0, 0],
             [0, 0, 0, 0, 0, 0, 6, 0, 0, 6],
             [0, 0, 0, 0, 0, 0, 0, 0, 6, 0],
             [0, 0, 0, 0, 0, 0, 0, 0, 0, 6]],

"mapa_17":  [[1, 0, 0, 0, 0, 2, 2, 0, 0, 1],
             [0, 0, 3, 0, 0, 0, 0, 0, 0, 0],
             [0, 0, 3, 0, 0, 0, 3, 3, 3, 0],
             [0, 0, 3, 0, 5, 0, 0, 0, 0, 0],
             [6, 0, 0, 0, 5, 0, 3, 0, 0, 6],
             [0, 6, 0, 0, 5, 0, 3, 0, 6, 0],
             [6, 0, 0, 0, 5, 0, 3, 0, 0, 6],
             [0, 0, 0, 0, 5, 0, 0, 0, 0, 0],
             [2, 0, 0, 0, 0, 0, 0, 0, 0, 0],
             [2, 0, 0, 4, 4, 4, 4, 0, 0, 1]],

"mapa_18":  [[3, 3, 3, 0, 3, 3, 3, 0, 0, 2],
             [0, 0, 0, 0, 0, 0, 0, 0, 0, 2],
             [4, 4, 4, 4, 0, 6, 0, 6, 0, 0],
             [0, 0, 0, 0, 0, 0, 6, 0, 0, 1],
             [2, 2, 0, 0, 0, 0, 0, 0, 0, 0],
             [0, 0, 0, 0, 0, 0, 0, 0, 0, 5],
             [0, 0, 0, 0, 0, 0, 6, 0, 0, 5],
             [0, 3, 0, 0, 0, 6, 0, 6, 0, 5],
             [0, 3, 0, 0, 0, 0, 0, 0, 0, 5],
             [0, 3, 0, 1, 0, 0, 0, 1, 0, 5]],

"mapa_19":  [[0, 0, 0, 0, 0, 0, 0, 6, 0, 6],
             [0, 4, 4, 4, 4, 0, 0, 0, 6, 0],
             [0, 0, 0, 0, 0, 0, 0, 0, 0, 0],
             [3, 0, 0, 6, 0, 0, 3, 0, 2, 2],
             [3, 0, 0, 0, 6, 0, 3, 0, 0, 0],
             [3, 0, 0, 6, 0, 0, 3, 0, 0, 5],
             [0, 0, 0, 0, 0, 0, 0, 0, 0, 5],
             [0, 1, 0, 0, 0, 0, 2, 2, 0, 5],
             [0, 0, 0, 0, 0, 0, 0, 0, 0, 5],
             [1, 0, 1, 0, 0, 3, 3, 3, 0, 5]],

"mapa_20":  [[0, 3, 0, 1, 0, 0, 0, 1, 0, 5],
             [0, 3, 0, 0, 0, 0, 0, 0, 0, 5],
             [0, 3, 0, 0, 0, 6, 0, 6, 0, 5],
             [0, 0, 0, 0, 0, 0, 6, 0, 0, 5],
             [0, 0, 0, 0, 0, 0, 0, 0, 0, 5],
             [2, 2, 0, 0, 0, 0, 0, 0, 0, 0],
             [0, 0, 0, 0, 0, 0, 6, 0, 0, 1],
             [4, 4, 4, 4, 0, 6, 0, 6, 0, 0],
             [0, 0, 0, 0, 0, 0, 0, 0, 0, 2],
             [3, 3, 3, 0, 3, 3, 3, 0, 0, 2]],

"mapa_21":  [[5, 0, 2, 0, 1, 0, 1, 0, 0, 0], 
             [5, 0, 2, 0, 0, 0, 0, 0, 0, 0],
             [5, 0, 0, 0, 1, 0, 0, 0, 0, 0],
             [5, 0, 3, 0, 0, 0, 0, 0, 0, 0],
             [5, 0, 3, 0, 2, 0, 0, 0, 0, 0],
             [0, 0, 3, 0, 2, 0, 6, 0, 0, 0],
             [4, 0, 0, 0, 0, 0, 0, 6, 0, 0],
             [4, 0, 3, 0, 3, 0, 6, 0, 0, 0],
             [4, 0, 3, 0, 3, 0, 0, 0, 6, 0],
             [4, 0, 3, 0, 3, 0, 0, 6, 0, 6]],

"mapa_default":  [[0, 0, 0, 0, 0, 0, 0, 0, 0, 0], 
                  [0, 0, 0, 0, 0, 0, 0, 0, 0, 0],
                  [0, 0, 0, 0, 0, 0, 0, 0, 0, 0],
                  [0, 0, 0, 0, 0, 0, 0, 0, 0, 0],
                  [0, 0, 0, 0, 0, 0, 0, 0, 0, 0],
                  [0, 0, 0, 0, 0, 0, 0, 0, 0, 0],
                  [0, 0, 0, 0, 0, 0, 0, 0, 0, 0],
                  [0, 0, 0, 0, 0, 0, 0, 0, 0, 0],
                  [0, 0, 0, 0, 0, 0, 0, 0, 0, 0],
                  [0, 0, 0, 0, 0, 0, 0, 0, 0, 0]]
}