{"mapa_pc": [[0, 0, 0, 0, 0, 0, 0, 0, 0, 0],
             [0, 0, 0, 0, 0, 0, 0, 0, 0, 0],
             [0, 0, 0, 0, 0, 0, 0, 0, 0, 0],
             [0, 0, 0, 0, 0, 0, 0, 0, 0, 0],
             [0, 0, 0, 0, 0, 0, 0, 0, 0, 0],
             [0, 0, 0, 0, 0, 0, 0, 0, 0, 0],
             [0, 0, 0, 0, 0, 0, 0, 0, 0, 0],
             [0, 0, 0, 0, 0, 0, 0, 0, 0, 0],
             [0, 0, 0, 0, 0, 0, 0, 0, 0, 0],
             [0, 0, 0, 0, 0, 0, 0, 0, 0, 0]],

 "mapa_ia": [[1, 0, 1, 0, 1, 0, 1, 0, 0, 0], 
             [1, 0, 1, 0, 0, 0, 0, 0, 0, 0],
             [1, 0, 0, 0, 1, 0, 0, 0, 0, 0],
             [1, 0, 1, 0, 0, 0, 0, 0, 0, 0],
             [1, 0, 1, 0, 1, 0, 0, 0, 0, 0],
             [0, 0, 1, 0, 1, 0, 1, 0, 0, 0],
             [1, 0, 0, 0, 0, 0, 0, 1, 0, 0],
             [1, 0, 1, 0, 1, 0, 1, 0, 0, 0],
             [1, 0, 1, 0, 1, 0, 0, 0, 1, 0],
             [1, 0, 1, 0, 1, 0, 0, 1, 0, 1]]
}